8
8
0 2 1 6 3
0 0 9 
0 0 0
0 1 0
0 2 0
0 3 0
0 4 0
0 5 0
0 6 0
0 7 0
1 0 0
1 2 3 2 Infinity
1 3 5 4
1 4 3 0 Infinity
1 7 0
2 0 0
2 1 6 0 2 1 1 5 0 0 0 3 0 3
2 6 6 0 2 1 1 5 0 2 2 3 2 3
2 7 0
3 0 0
3 1 6 0 2 1 1 5 0 0 0 3 0 3
3 6 6 0 2 1 1 5 0 2 2 3 2 3
3 7 0
4 0 0
4 1 6 0 2 1 1 5 0 0 0 3 0 3
4 6 6 0 2 1 1 5 0 2 2 3 2 3
4 7 0
5 0 0
5 1 6 0 2 1 1 5 0 0 0 3 0 3
5 6 6 0 2 1 1 5 0 2 2 3 2 3
5 7 0
6 0 0
6 1 6 0 1 1 10 4 0 3 0 3 3 3
6 6 6 0 1 1 10 4 0 3 2 3 3 3
6 7 0
7 0 0
7 1 0
7 2 0
7 3 0
7 4 0
7 5 0
7 6 0
7 7 0
