8
8
0 2
0 3 5 15
0 4 3 2 0
1 4 0 3
1 5 0 3
1 7 6 0 1 10 7 7 2 0 2 3
2 4 0 3
2 5 0 3
2 7 6 0 1 10 7 7 2 0 2 3
3 7 6 0 1 10 7 7 2 0 2 3
4 7 6 0 1 10 7 7 2 0 2 3
5 7 6 0 1 10 7 7 2 0 2 3
6 7 6 0 1 10 7 7 2 0 2 3
